NO ./map/64x/Bricks.xpm
SO ./map/64x/BrickOv.xpm
WE ./map/64x/bookshelf.xpm
EA ./map/64x/Gold1.xpm

F 220,100,0
C 225,30,0

        1111111111111111111111111
        1000000000110000000000001
        1011000001110000000000001
        1001000000000000000000001
111111111011000001110000000000001
1W1000000011000001110001111111111
11110011111111011100000010001
11110011111111011101010010001
11000000110101011100000010001
10000000000000001100000000001
10000000000000000000010010001
11000001110111011100011110001
11110111 111 101 100011110001
11111111 111 111 111111111111

